111111111111111
1P0000101000C11
1110000C0000101
1C00E111100C001
100000000000001
111111111111111
