111111111111111
1E00000000C0001
1111000000000C1
100000011111111
1100000000C1111
111101111111111