11111111111111
1E00C0C00P001 
10000000000001
10000000000001
1000000000001 
11111111111111