01111111111
1P0C000T0E1
11111111111