1111111111111111111111
100000000000P00000C001
1000E00000000000000001
1111111111100111000001
100000C000000C10000111
1111111111111111111111
